{
  "name": "Default",
  "coords": {
    "pacman": { "x": 28, "y": 47 },
    "blinky": { "x": 28, "y": 23 },
    "pinky": { "x": 28, "y": 29 },
    "inky": { "x": 24, "y": 29 },
    "clyde": { "x": 32, "y": 29 }
  },
  "grid": [
    [
      7, 3, 3, 3, 3, 3, 3, 3, 3, 3, 3, 3, 3, 3, 3, 3, 3, 3, 3, 3, 3, 3, 3, 3, 3,
      3, 3, 3, 3, 3, 3, 3, 3, 3, 3, 3, 3, 3, 3, 3, 3, 3, 3, 3, 3, 3, 3, 3, 3, 3,
      3, 3, 3, 3, 3, 3, 6
    ],
    [
      2, 7, 3, 3, 3, 3, 3, 3, 3, 3, 3, 3, 3, 3, 3, 3, 3, 3, 3, 3, 3, 3, 3, 3, 3,
      3, 3, 6, 0, 7, 3, 3, 3, 3, 3, 3, 3, 3, 3, 3, 3, 3, 3, 3, 3, 3, 3, 3, 3, 3,
      3, 3, 3, 3, 3, 6, 2
    ],
    [
      2, 2, 0, 0, 0, 0, 0, 0, 0, 0, 0, 0, 0, 0, 0, 0, 0, 0, 0, 0, 0, 0, 0, 0, 0,
      0, 0, 2, 0, 2, 0, 0, 0, 0, 0, 0, 0, 0, 0, 0, 0, 0, 0, 0, 0, 0, 0, 0, 0, 0,
      0, 0, 0, 0, 0, 2, 2
    ],
    [
      2, 2, 0, 8, 1, 8, 1, 8, 1, 8, 1, 8, 1, 8, 1, 8, 1, 8, 1, 8, 1, 8, 1, 8, 1,
      8, 0, 2, 0, 2, 0, 8, 1, 8, 1, 8, 1, 8, 1, 8, 1, 8, 1, 8, 1, 8, 1, 8, 1, 8,
      1, 8, 1, 8, 0, 2, 2
    ],
    [
      2, 2, 0, 1, 0, 0, 0, 0, 0, 0, 0, 0, 0, 1, 0, 0, 0, 0, 0, 0, 0, 0, 0, 0, 0,
      1, 0, 2, 0, 2, 0, 1, 0, 0, 0, 0, 0, 0, 0, 0, 0, 0, 0, 1, 0, 0, 0, 0, 0, 0,
      0, 0, 0, 1, 0, 2, 2
    ],
    [
      2, 2, 0, 8, 0, 7, 3, 3, 3, 3, 3, 6, 0, 8, 0, 7, 3, 3, 3, 3, 3, 3, 3, 6, 0,
      8, 0, 2, 0, 2, 0, 8, 0, 7, 3, 3, 3, 3, 3, 3, 3, 6, 0, 8, 0, 7, 3, 3, 3, 3,
      3, 6, 0, 8, 0, 2, 2
    ],
    [
      2, 2, 0, 1, 0, 2, 0, 0, 0, 0, 0, 2, 0, 1, 0, 2, 0, 0, 0, 0, 0, 0, 0, 2, 0,
      1, 0, 2, 0, 2, 0, 1, 0, 2, 0, 0, 0, 0, 0, 0, 0, 2, 0, 1, 0, 2, 0, 0, 0, 0,
      0, 2, 0, 1, 0, 2, 2
    ],
    [
      2, 2, 0, 8, 0, 2, 0, 0, 0, 0, 0, 2, 0, 8, 0, 2, 0, 0, 0, 0, 0, 0, 0, 2, 0,
      8, 0, 2, 0, 2, 0, 8, 0, 2, 0, 0, 0, 0, 0, 0, 0, 2, 0, 8, 0, 2, 0, 0, 0, 0,
      0, 2, 0, 8, 0, 2, 2
    ],
    [
      2, 2, 0, 1, 0, 2, 0, 0, 0, 0, 0, 2, 0, 1, 0, 2, 0, 0, 0, 0, 0, 0, 0, 2, 0,
      1, 0, 2, 0, 2, 0, 1, 0, 2, 0, 0, 0, 0, 0, 0, 0, 2, 0, 1, 0, 2, 0, 0, 0, 0,
      0, 2, 0, 1, 0, 2, 2
    ],
    [
      2, 2, 0, 8, 0, 5, 3, 3, 3, 3, 3, 4, 0, 8, 0, 5, 3, 3, 3, 3, 3, 3, 3, 4, 0,
      8, 0, 5, 3, 4, 0, 8, 0, 5, 3, 3, 3, 3, 3, 3, 3, 4, 0, 8, 0, 5, 3, 3, 3, 3,
      3, 4, 0, 8, 0, 2, 2
    ],
    [
      2, 2, 0, 1, 0, 0, 0, 0, 0, 0, 0, 0, 0, 1, 0, 0, 0, 0, 0, 0, 0, 0, 0, 0, 0,
      1, 0, 0, 0, 0, 0, 1, 0, 0, 0, 0, 0, 0, 0, 0, 0, 0, 0, 1, 0, 0, 0, 0, 0, 0,
      0, 0, 0, 1, 0, 2, 2
    ],
    [
      2, 2, 0, 8, 1, 8, 1, 8, 1, 8, 1, 8, 1, 8, 1, 8, 1, 8, 1, 8, 1, 8, 1, 8, 1,
      8, 1, 8, 1, 8, 1, 8, 1, 8, 1, 8, 1, 8, 1, 8, 1, 8, 1, 8, 1, 8, 1, 8, 1, 8,
      1, 8, 1, 8, 0, 2, 2
    ],
    [
      2, 2, 0, 1, 0, 0, 0, 0, 0, 0, 0, 0, 0, 1, 0, 0, 0, 0, 0, 1, 0, 0, 0, 0, 0,
      0, 0, 0, 0, 0, 0, 0, 0, 0, 0, 0, 0, 1, 0, 0, 0, 0, 0, 1, 0, 0, 0, 0, 0, 0,
      0, 0, 0, 1, 0, 2, 2
    ],
    [
      2, 2, 0, 8, 0, 7, 3, 3, 3, 3, 3, 6, 0, 8, 0, 7, 3, 6, 0, 8, 0, 7, 3, 3, 3,
      3, 3, 3, 3, 3, 3, 3, 3, 3, 3, 6, 0, 8, 0, 7, 3, 6, 0, 8, 0, 7, 3, 3, 3, 3,
      3, 6, 0, 8, 0, 2, 2
    ],
    [
      2, 2, 0, 1, 0, 2, 0, 0, 0, 0, 0, 2, 0, 1, 0, 2, 0, 2, 0, 1, 0, 2, 0, 0, 0,
      0, 0, 0, 0, 0, 0, 0, 0, 0, 0, 2, 0, 1, 0, 2, 0, 2, 0, 1, 0, 2, 0, 0, 0, 0,
      0, 2, 0, 1, 0, 2, 2
    ],
    [
      2, 2, 0, 8, 0, 5, 3, 3, 3, 3, 3, 4, 0, 8, 0, 2, 0, 2, 0, 8, 0, 5, 3, 3, 3,
      3, 3, 6, 0, 7, 3, 3, 3, 3, 3, 4, 0, 8, 0, 2, 0, 2, 0, 8, 0, 5, 3, 3, 3, 3,
      3, 4, 0, 8, 0, 2, 2
    ],
    [
      2, 2, 0, 1, 0, 0, 0, 0, 0, 0, 0, 0, 0, 1, 0, 2, 0, 2, 0, 1, 0, 0, 0, 0, 0,
      0, 0, 2, 0, 2, 0, 0, 0, 0, 0, 0, 0, 1, 0, 2, 0, 2, 0, 1, 0, 0, 0, 0, 0, 0,
      0, 0, 0, 1, 0, 2, 2
    ],
    [
      2, 2, 0, 8, 1, 8, 1, 8, 1, 8, 1, 8, 1, 8, 0, 2, 0, 2, 0, 8, 1, 8, 1, 8, 1,
      8, 0, 2, 0, 2, 0, 8, 1, 8, 1, 8, 1, 8, 0, 2, 0, 2, 0, 8, 1, 8, 1, 8, 1, 8,
      1, 8, 1, 8, 0, 2, 2
    ],
    [
      2, 2, 0, 0, 0, 0, 0, 0, 0, 0, 0, 0, 0, 1, 0, 2, 0, 2, 0, 0, 0, 0, 0, 0, 0,
      1, 0, 2, 0, 2, 0, 1, 0, 0, 0, 0, 0, 0, 0, 2, 0, 2, 0, 1, 0, 0, 0, 0, 0, 0,
      0, 0, 0, 0, 0, 2, 2
    ],
    [
      2, 5, 3, 3, 3, 3, 3, 3, 3, 3, 3, 6, 0, 8, 0, 2, 0, 5, 3, 3, 3, 3, 3, 6, 0,
      1, 0, 2, 0, 2, 0, 1, 0, 7, 3, 3, 3, 3, 3, 4, 0, 2, 0, 8, 0, 7, 3, 3, 3, 3,
      3, 3, 3, 3, 3, 4, 2
    ],
    [
      5, 3, 3, 3, 3, 3, 3, 3, 3, 3, 6, 2, 0, 1, 0, 2, 0, 0, 0, 0, 0, 0, 0, 2, 0,
      1, 0, 2, 0, 2, 0, 1, 0, 2, 0, 0, 0, 0, 0, 0, 0, 2, 0, 1, 0, 2, 7, 3, 3, 3,
      3, 3, 3, 3, 3, 3, 4
    ],
    [
      0, 0, 0, 0, 0, 0, 0, 0, 0, 0, 2, 2, 0, 8, 0, 2, 0, 7, 3, 3, 3, 3, 3, 4, 0,
      1, 0, 5, 3, 4, 0, 1, 0, 5, 3, 3, 3, 3, 3, 6, 0, 2, 0, 8, 0, 2, 2, 0, 0, 0,
      0, 0, 0, 0, 0, 0, 0
    ],
    [
      0, 0, 0, 0, 0, 0, 0, 0, 0, 0, 2, 2, 0, 1, 0, 2, 0, 2, 0, 0, 0, 0, 0, 0, 0,
      1, 0, 0, 0, 0, 0, 1, 0, 0, 0, 0, 0, 0, 0, 2, 0, 2, 0, 1, 0, 2, 2, 0, 0, 0,
      0, 0, 0, 0, 0, 0, 0
    ],
    [
      0, 0, 0, 0, 0, 0, 0, 0, 0, 0, 2, 2, 0, 8, 0, 2, 0, 2, 0, 1, 1, 1, 1, 1, 1,
      1, 1, 1, 1, 1, 1, 1, 1, 1, 1, 1, 1, 1, 0, 2, 0, 2, 0, 8, 0, 2, 2, 0, 0, 0,
      0, 0, 0, 0, 0, 0, 0
    ],
    [
      0, 0, 0, 0, 0, 0, 0, 0, 0, 0, 2, 2, 0, 1, 0, 2, 0, 2, 0, 1, 0, 0, 0, 0, 0,
      0, 0, 0, 0, 0, 0, 0, 0, 0, 0, 0, 0, 1, 0, 2, 0, 2, 0, 1, 0, 2, 2, 0, 0, 0,
      0, 0, 0, 0, 0, 0, 0
    ],
    [
      0, 0, 0, 0, 0, 0, 0, 0, 0, 0, 2, 2, 0, 8, 0, 2, 0, 2, 0, 1, 0, 7, 3, 3, 3,
      3, 9, 9, 9, 9, 9, 3, 3, 3, 3, 6, 0, 1, 0, 2, 0, 2, 0, 8, 0, 2, 2, 0, 0, 0,
      0, 0, 0, 0, 0, 0, 0
    ],
    [
      3, 3, 3, 3, 3, 3, 3, 3, 3, 3, 4, 2, 0, 1, 0, 2, 0, 2, 0, 1, 0, 2, 7, 3, 3,
      3, 0, 0, 0, 0, 0, 3, 3, 3, 6, 2, 0, 1, 0, 2, 0, 2, 0, 1, 0, 2, 5, 3, 3, 3,
      3, 3, 3, 3, 3, 3, 3
    ],
    [
      3, 3, 3, 3, 3, 3, 3, 3, 3, 3, 3, 4, 0, 8, 0, 5, 3, 4, 0, 1, 0, 2, 2, 0, 0,
      0, 0, 0, 0, 0, 0, 0, 0, 0, 2, 2, 0, 1, 0, 5, 3, 4, 0, 8, 0, 5, 3, 3, 3, 3,
      3, 3, 3, 3, 3, 3, 3
    ],
    [
      0, 0, 0, 0, 0, 0, 0, 0, 0, 0, 0, 0, 0, 1, 0, 0, 0, 0, 0, 1, 0, 2, 2, 0, 0,
      0, 0, 0, 0, 0, 0, 0, 0, 0, 2, 2, 0, 1, 0, 0, 0, 0, 0, 1, 0, 0, 0, 0, 0, 0,
      0, 0, 0, 0, 0, 0, 0
    ],
    [
      1, 1, 1, 1, 1, 1, 1, 1, 1, 1, 1, 1, 1, 8, 1, 1, 1, 1, 1, 1, 0, 2, 2, 0, 0,
      0, 0, 0, 0, 0, 0, 0, 0, 0, 2, 2, 0, 1, 1, 1, 1, 1, 1, 8, 1, 1, 1, 1, 1, 1,
      1, 1, 1, 1, 1, 1, 1
    ],
    [
      0, 0, 0, 0, 0, 0, 0, 0, 0, 0, 0, 0, 0, 1, 0, 0, 0, 0, 0, 1, 0, 2, 2, 0, 0,
      0, 0, 0, 0, 0, 0, 0, 0, 0, 2, 2, 0, 1, 0, 0, 0, 0, 0, 1, 0, 0, 0, 0, 0, 0,
      0, 0, 0, 0, 0, 0, 0
    ],
    [
      3, 3, 3, 3, 3, 3, 3, 3, 3, 3, 3, 6, 0, 8, 0, 7, 3, 6, 0, 1, 0, 2, 2, 0, 0,
      0, 0, 0, 0, 0, 0, 0, 0, 0, 2, 2, 0, 1, 0, 7, 3, 6, 0, 8, 0, 7, 3, 3, 3, 3,
      3, 3, 3, 3, 3, 3, 3
    ],
    [
      3, 3, 3, 3, 3, 3, 3, 3, 3, 3, 6, 2, 0, 1, 0, 2, 0, 2, 0, 1, 0, 2, 5, 3, 3,
      3, 3, 3, 3, 3, 3, 3, 3, 3, 4, 2, 0, 1, 0, 2, 0, 2, 0, 1, 0, 2, 7, 3, 3, 3,
      3, 3, 3, 3, 3, 3, 3
    ],
    [
      0, 0, 0, 0, 0, 0, 0, 0, 0, 0, 2, 2, 0, 8, 0, 2, 0, 2, 0, 1, 0, 5, 3, 3, 3,
      3, 3, 3, 3, 3, 3, 3, 3, 3, 3, 4, 0, 1, 0, 2, 0, 2, 0, 8, 0, 2, 2, 0, 0, 0,
      0, 0, 0, 0, 0, 0, 0
    ],
    [
      0, 0, 0, 0, 0, 0, 0, 0, 0, 0, 2, 2, 0, 1, 0, 2, 0, 2, 0, 1, 0, 0, 0, 0, 0,
      0, 0, 0, 0, 0, 0, 0, 0, 0, 0, 0, 0, 1, 0, 2, 0, 2, 0, 1, 0, 2, 2, 0, 0, 0,
      0, 0, 0, 0, 0, 0, 0
    ],
    [
      0, 0, 0, 0, 0, 0, 0, 0, 0, 0, 2, 2, 0, 8, 0, 2, 0, 2, 0, 1, 1, 1, 1, 1, 1,
      1, 1, 1, 1, 1, 1, 1, 1, 1, 1, 1, 1, 1, 0, 2, 0, 2, 0, 8, 0, 2, 2, 0, 0, 0,
      0, 0, 0, 0, 0, 0, 0
    ],
    [
      0, 0, 0, 0, 0, 0, 0, 0, 0, 0, 2, 2, 0, 1, 0, 2, 0, 2, 0, 1, 0, 0, 0, 0, 0,
      0, 0, 0, 0, 0, 0, 0, 0, 0, 0, 0, 0, 1, 0, 2, 0, 2, 0, 1, 0, 2, 2, 0, 0, 0,
      0, 0, 0, 0, 0, 0, 0
    ],
    [
      0, 0, 0, 0, 0, 0, 0, 0, 0, 0, 2, 2, 0, 8, 0, 2, 0, 2, 0, 1, 0, 7, 3, 3, 3,
      3, 3, 3, 3, 3, 3, 3, 3, 3, 3, 6, 0, 1, 0, 2, 0, 2, 0, 8, 0, 2, 2, 0, 0, 0,
      0, 0, 0, 0, 0, 0, 0
    ],
    [
      7, 3, 3, 3, 3, 3, 3, 3, 3, 3, 4, 2, 0, 1, 0, 2, 0, 2, 0, 1, 0, 2, 0, 0, 0,
      0, 0, 0, 0, 0, 0, 0, 0, 0, 0, 2, 0, 1, 0, 2, 0, 2, 0, 1, 0, 2, 5, 3, 3, 3,
      3, 3, 3, 3, 3, 3, 6
    ],
    [
      2, 7, 3, 3, 3, 3, 3, 3, 3, 3, 3, 4, 0, 8, 0, 5, 3, 4, 0, 1, 0, 5, 3, 3, 3,
      3, 3, 6, 0, 7, 3, 3, 3, 3, 3, 4, 0, 1, 0, 5, 3, 4, 0, 8, 0, 5, 3, 3, 3, 3,
      3, 3, 3, 3, 3, 6, 2
    ],
    [
      2, 2, 0, 0, 0, 0, 0, 0, 0, 0, 0, 0, 0, 1, 0, 0, 0, 0, 0, 1, 0, 0, 0, 0, 0,
      0, 0, 2, 0, 2, 0, 0, 0, 0, 0, 0, 0, 1, 0, 0, 0, 0, 0, 1, 0, 0, 0, 0, 0, 0,
      0, 0, 0, 0, 0, 2, 2
    ],
    [
      2, 2, 0, 8, 1, 8, 1, 8, 1, 8, 1, 8, 1, 8, 1, 8, 1, 8, 1, 8, 1, 8, 1, 8, 1,
      8, 0, 2, 0, 2, 0, 8, 1, 8, 1, 8, 1, 8, 1, 8, 1, 8, 1, 8, 1, 8, 1, 8, 1, 8,
      1, 8, 1, 8, 0, 2, 2
    ],
    [
      2, 2, 0, 1, 0, 0, 0, 0, 0, 0, 0, 0, 0, 1, 0, 0, 0, 0, 0, 0, 0, 0, 0, 0, 0,
      1, 0, 2, 0, 2, 0, 1, 0, 0, 0, 0, 0, 0, 0, 0, 0, 0, 0, 1, 0, 0, 0, 0, 0, 0,
      0, 0, 0, 1, 0, 2, 2
    ],
    [
      2, 2, 0, 8, 0, 7, 3, 3, 3, 3, 3, 6, 0, 8, 0, 7, 3, 3, 3, 3, 3, 3, 3, 6, 0,
      8, 0, 2, 0, 2, 0, 8, 0, 7, 3, 3, 3, 3, 3, 3, 3, 6, 0, 8, 0, 7, 3, 3, 3, 3,
      3, 6, 0, 8, 0, 2, 2
    ],
    [
      2, 2, 0, 1, 0, 2, 0, 0, 0, 0, 0, 2, 0, 1, 0, 2, 0, 0, 0, 0, 0, 0, 0, 2, 0,
      1, 0, 2, 0, 2, 0, 1, 0, 2, 0, 0, 0, 0, 0, 0, 0, 2, 0, 1, 0, 2, 0, 0, 0, 0,
      0, 2, 0, 1, 0, 2, 2
    ],
    [
      2, 2, 0, 8, 0, 5, 3, 3, 3, 6, 0, 2, 0, 8, 0, 5, 3, 3, 3, 3, 3, 3, 3, 4, 0,
      8, 0, 5, 3, 4, 0, 8, 0, 5, 3, 3, 3, 3, 3, 3, 3, 4, 0, 8, 0, 2, 0, 7, 3, 3,
      3, 4, 0, 8, 0, 2, 2
    ],
    [
      2, 2, 0, 1, 0, 0, 0, 0, 0, 2, 0, 2, 0, 1, 0, 0, 0, 0, 0, 0, 0, 0, 0, 0, 0,
      1, 0, 0, 0, 0, 0, 1, 0, 0, 0, 0, 0, 0, 0, 0, 0, 0, 0, 1, 0, 2, 0, 2, 0, 0,
      0, 0, 0, 1, 0, 2, 2
    ],
    [
      2, 2, 0, 8, 1, 8, 1, 8, 0, 2, 0, 2, 0, 8, 1, 8, 1, 8, 1, 8, 1, 8, 1, 8, 1,
      8, 1, 1, 1, 1, 1, 8, 1, 8, 1, 8, 1, 8, 1, 8, 1, 8, 1, 8, 0, 2, 0, 2, 0, 8,
      1, 8, 1, 8, 0, 2, 2
    ],
    [
      2, 2, 0, 0, 0, 0, 0, 1, 0, 2, 0, 2, 0, 1, 0, 0, 0, 0, 0, 1, 0, 0, 0, 0, 0,
      0, 0, 0, 0, 0, 0, 0, 0, 0, 0, 0, 0, 1, 0, 0, 0, 0, 0, 1, 0, 2, 0, 2, 0, 1,
      0, 0, 0, 0, 0, 2, 2
    ],
    [
      2, 5, 3, 3, 3, 6, 0, 8, 0, 2, 0, 2, 0, 8, 0, 7, 3, 6, 0, 8, 0, 7, 3, 3, 3,
      3, 3, 3, 3, 3, 3, 3, 3, 3, 3, 6, 0, 8, 0, 7, 3, 6, 0, 8, 0, 2, 0, 2, 0, 8,
      0, 7, 3, 3, 3, 4, 2
    ],
    [
      2, 0, 0, 0, 0, 2, 0, 1, 0, 2, 0, 2, 0, 1, 0, 2, 0, 2, 0, 1, 0, 2, 0, 0, 0,
      0, 0, 0, 0, 0, 0, 0, 0, 0, 0, 2, 0, 1, 0, 2, 0, 2, 0, 1, 0, 2, 0, 2, 0, 1,
      0, 2, 0, 0, 0, 0, 2
    ],
    [
      2, 7, 3, 3, 3, 4, 0, 8, 0, 5, 3, 4, 0, 8, 0, 2, 0, 2, 0, 8, 0, 5, 3, 3, 3,
      3, 3, 6, 0, 7, 3, 3, 3, 3, 3, 4, 0, 8, 0, 2, 0, 2, 0, 8, 0, 5, 3, 4, 0, 8,
      0, 5, 3, 3, 3, 6, 2
    ],
    [
      2, 2, 0, 0, 0, 0, 0, 1, 0, 0, 0, 0, 0, 1, 0, 2, 0, 2, 0, 1, 0, 0, 0, 0, 0,
      0, 0, 2, 0, 2, 0, 0, 0, 0, 0, 0, 0, 1, 0, 2, 0, 2, 0, 1, 0, 0, 0, 0, 0, 1,
      0, 0, 0, 0, 0, 2, 2
    ],
    [
      2, 2, 0, 8, 1, 8, 1, 8, 1, 8, 1, 8, 1, 8, 0, 2, 0, 2, 0, 8, 1, 8, 1, 8, 1,
      8, 0, 2, 0, 2, 0, 8, 1, 8, 1, 8, 1, 8, 0, 2, 0, 2, 0, 8, 1, 8, 1, 8, 1, 8,
      1, 8, 1, 8, 0, 2, 2
    ],
    [
      2, 2, 0, 1, 0, 0, 0, 0, 0, 0, 0, 0, 0, 0, 0, 2, 0, 2, 0, 0, 0, 0, 0, 0, 0,
      1, 0, 2, 0, 2, 0, 1, 0, 0, 0, 0, 0, 0, 0, 2, 0, 2, 0, 0, 0, 0, 0, 0, 0, 0,
      0, 0, 0, 1, 0, 2, 2
    ],
    [
      2, 2, 0, 8, 0, 7, 3, 3, 3, 3, 3, 3, 3, 3, 3, 4, 0, 5, 3, 3, 3, 3, 3, 6, 0,
      8, 0, 2, 0, 2, 0, 8, 0, 7, 3, 3, 3, 3, 3, 4, 0, 5, 3, 3, 3, 3, 3, 3, 3, 3,
      3, 6, 0, 8, 0, 2, 2
    ],
    [
      2, 2, 0, 1, 0, 2, 0, 0, 0, 0, 0, 0, 0, 0, 0, 0, 0, 0, 0, 0, 0, 0, 0, 2, 0,
      1, 0, 2, 0, 2, 0, 1, 0, 2, 0, 0, 0, 0, 0, 0, 0, 0, 0, 0, 0, 0, 0, 0, 0, 0,
      0, 2, 0, 1, 0, 2, 2
    ],
    [
      2, 2, 0, 8, 0, 5, 3, 3, 3, 3, 3, 3, 3, 3, 3, 3, 3, 3, 3, 3, 3, 3, 3, 4, 0,
      8, 0, 5, 3, 4, 0, 8, 0, 5, 3, 3, 3, 3, 3, 3, 3, 3, 3, 3, 3, 3, 3, 3, 3, 3,
      3, 4, 0, 8, 0, 2, 2
    ],
    [
      2, 2, 0, 1, 0, 0, 0, 0, 0, 0, 0, 0, 0, 0, 0, 0, 0, 0, 0, 0, 0, 0, 0, 0, 0,
      1, 0, 0, 0, 0, 0, 1, 0, 0, 0, 0, 0, 0, 0, 0, 0, 0, 0, 0, 0, 0, 0, 0, 0, 0,
      0, 0, 0, 1, 0, 2, 2
    ],
    [
      2, 2, 0, 8, 1, 8, 1, 8, 1, 8, 1, 8, 1, 8, 1, 8, 1, 8, 1, 8, 1, 8, 1, 8, 1,
      8, 1, 8, 1, 8, 1, 8, 1, 8, 1, 8, 1, 8, 1, 8, 1, 8, 1, 8, 1, 8, 1, 8, 1, 8,
      1, 8, 1, 8, 0, 2, 2
    ],
    [
      2, 2, 0, 0, 0, 0, 0, 0, 0, 0, 0, 0, 0, 0, 0, 0, 0, 0, 0, 0, 0, 0, 0, 0, 0,
      0, 0, 0, 0, 0, 0, 0, 0, 0, 0, 0, 0, 0, 0, 0, 0, 0, 0, 0, 0, 0, 0, 0, 0, 0,
      0, 0, 0, 0, 0, 2, 2
    ],
    [
      2, 5, 3, 3, 3, 3, 3, 3, 3, 3, 3, 3, 3, 3, 3, 3, 3, 3, 3, 3, 3, 3, 3, 3, 3,
      3, 3, 3, 3, 3, 3, 3, 3, 3, 3, 3, 3, 3, 3, 3, 3, 3, 3, 3, 3, 3, 3, 3, 3, 3,
      3, 3, 3, 3, 3, 4, 2
    ],
    [
      5, 3, 3, 3, 3, 3, 3, 3, 3, 3, 3, 3, 3, 3, 3, 3, 3, 3, 3, 3, 3, 3, 3, 3, 3,
      3, 3, 3, 3, 3, 3, 3, 3, 3, 3, 3, 3, 3, 3, 3, 3, 3, 3, 3, 3, 3, 3, 3, 3, 3,
      3, 3, 3, 3, 3, 3, 4
    ]
  ]
}
